. . . . . .
. 1 . . 0 .
. . . . . .
. . . . . .
. . . . . .
. 2 . . . .